22x15
######################
#       #            #
# O #   #         #  #
# # #   #         #  #
#         # # #   #  #
# # # #   #   #   #  #
#     #   #   #   #  #
# #   #   #   #   ####
#           #      # #
# # # # # # #  # # # #
#       #      #     #
#       #  #   #######
#       #  #   #   T #
#          #         #
######################