18x13
##################
#                #
# BBBBBMBBD      #
#        B       #
# BBBBBMBMBBBB   #
#                #
# O              #
# BBBBBBBBBBBB   #
#                #
#                #
#                #
#                #
##################