##########
#        #
# B      #
# O *    #
#   G    #
#        #
#        #
#        #
#        #
##########